 #####  
 #   ###
## #X  #
#P O O #
#   XX##
##  #O# 
 ##   # 
  ##### 
