  ####   
  #  ####
  #     #
### ##  #
#OO  # ##
#OO  # # 
# #### ##
# # X   #
# # XXX #
# P  #  #
#########
