#########
#       #
#   P   #
#       #
#  X    #
#       #
#     O #
#       #
#########
