##########
#O # O# O#
# PX  #  #
#  X  #  #
#  X     #
#  #     #
##########
