......................
.                    .
. ##  ##  ##  ##  ## .
. #    #      #    # .
.                    .
.                    .
. #    #      #    # .
. ##  ##      ##  ## .
.                    .
.                    .
. #                # .
. #                # .
.                    .
.                    .
. ##  ##      ##  ## .
. #    #      #    # .
.                    .
.                    .
. #    #      #    # .
. ##  ##  ##  ##  ## .
.                    .
......................