......................
.                   #.
.     #              .
.#         #         .
.             #      .
.        #           .
.  #                 .
.               #    .
.       #        #   .
.   #                .
.             #      .
.     #              .
. #             #    .
.                   #.
.                    .
.       #          # .
.    #      #        .
.               #    .
.     #              .
.              #     .
.   #    #           .
......................
