......................
.                    .
.                    .
.        #  #        .
.       #    #       .
.      ##    ##      .
.       #    #       .
.       #    #       .
.       #    #       .
.       #    #       .
.       #    #       .
.       #    #       .
.       #    #       .
.     ##      ##     .
.    #          #    .
.    #          #    .
.    #          #    .
.    #          #    .
.     ##########     .
.                    .
.                    .
......................